NO ./textures/north.xpm
SO ./textures/south.xpm
WE ./textures/west.xpm
EA ./textures/east.xpm
F 255,200,100
C 100,100,200

      11111111111
      10000000001
1111111000000000111111
1000000000W00000000001
1111111000000000111111
      10000000001
      11111111111
