NO ./textures/north.xpm
SO ./textures/south.xpm
WE ./textures/west.xpm
EA ./textures/east.xpm
F 100,100,100
C 200,200,255

11111
10001
10N01
10001
1000111111
1000000001
1111110001
   10001
   10001
   11111
