NO ./textures/north.xpm
SO ./textures/south.xpm
WE ./textures/west.xpm
EA ./textures/east.xpm
F 70,70,70
C 180,180,200

11111111
10000001
10000001111111
10000000000001
10E00000000001
10000000000001
10000001111111
10000001
11111111