NO ./textures/north.xpm
SO ./textures/south.xpm
WE ./textures/west.xpm
EA ./textures/east.xpm
F 64,32,16
C 128,192,255

111111111111111111
100000000000000001
101111111111111101
101000000000000101
101011111111110101
101010S000001010101
101011111111110101
101000000000000101
101111111111111101
100000000000000001
111111111111111111
