NO ./textures/north.xpm
SO ./textures/south.xpm
WE ./textures/west.xpm
EA ./textures/east.xpm
F 50,100,150
C 150,200,250

   11111
   10001
   10001
   10001
1111000111111
1000000000001
1000N00000001
1000000000001
1111000111111
   10001
   10001
   10001
   11111
