NO ./textures/north.xpm
SO ./textures/south.xpm
WE ./textures/west.xpm
EA ./textures/east.xpm
F 80,80,80
C 120,120,200

1111111111111
1000000000001
1011111110001
1010000010001
1010W10010001
1010000010001
1011111110001
1000000000001
1111111111111
