NO ./textures/north.xpm
SO ./textures/south.xpm
WE ./textures/west.xpm
EA ./textures/east.xpm
F 220,100,0
C 225,30,0

11111
10001
10N01
10001
1000111111111111
1000000000000001
1111111110000001
       100000001
       100000001
       1000001111111
       1000000000001
       1111111000001
             1000001
             1111111
