NO ./textures/north.xpm
SO ./textures/south.xpm
WE ./textures/west.xpm
EA ./textures/east.xpm
F 255,255,200
C 50,50,100

    1111111
    1000001
    1000001
1111100S001
1000000000111111
1000000000000001
111111000000000111111
     1000000000000001
     1111110000000001
         100000000011
         11111111111
