NO ./textures/north.xpm
SO ./textures/south.xpm
WE ./textures/west.xpm
EA ./textures/east.xpm
F 200,150,100
C 50,100,150

     1111111111
     1000000001
     1000000001
111111000000001
100000000000001
10000N000000001
100000000000001
111111000000001
     1000000001
     1000000001
     1111111111
