NO ./textures/north.xpm
SO ./textures/south.xpm
WE ./textures/west.xpm
EA ./textures/east.xpm
F 100,50,0
C 200,220,255

        111111111
        100000001
1111111110000000111111111
1000000000000000000000001
1000000000000000000000001
10N0000000000000000000001
1000000000000000000000001
1000000000000000000000001
1111111110000000111111111
        100000001
        111111111
