NO ./textures/north.xpm

SO ./textures/south.xpm


WE ./textures/west.xpm
EA ./textures/east.xpm

F 0,255,0

C 135,206,235

1111111111
1000000001
1000S00001
1000000001
1111111111
