NO ./textures/north.xpm
SO ./textures/south.xpm
WE ./textures/west.xpm
EA ./textures/east.xpm
F 90,60,30
C 150,180,220

111111     111111
100001     100001
10N001     100001
100001     100001
10000111111100001
10000000000000001
11111100011111111
     10001
     10001
     10001
     11111
