NO ./textures/north.xpm
SO ./textures/south.xpm
WE ./textures/west.xpm
EA ./textures/east.xpm
F 90,60,30
C 150,180,220

111111     111111
100001     100001
10N001     100001
100001     100001
1000011111110001
1000000000000001
1111110001111111
     10001
     10001
     10001
     11111
