NO ./textures/north.xpm
SO ./textures/south.xpm
WE ./textures/west.xpm
EA ./textures/east.xpm
F 220,100,0
C 225,30,0

111111       111111
100001       100001
100001       100001
100001111111110000
1000000000000000001
100000000N000000001
1000000000000000001
1000011111111100001
100001       100001
100001       100001
111111       111111
