NO ./textures/north.xpm
SO ./textures/south.xdm
WE ./textures/west.xpm
EA ./textures/east.xpm
F 180,140,100
C 100,150,200

111111       111111
100001       100001
100001       100001
1000011111111100001
1000000000000000001
100000000E000000001
1000000000000000001
1000011111111100001
100001       100001
100001       100001
111111       111111
