NO ./textures/north.xpm
SO ./textures/south.xpm
WE ./textures/west.xpm
EA ./textures/test.xpm
F 200,200,200
C 50,50,50

1111
1001
10E1
1001
1001111
1000001
1111001
   1001
   10011111
   100000011
   111110001
       10001
       11111
