NO ./textures/north.xpm
SO ./textures/south.xpm
WE ./textures/west.xpm
EA ./textures/east.xpm
F 220,100,0
C 225,30,0

11111
10001
10N01
10001
10001111111
000000000001
1111110001
   10001
   10001
   11111
