NO ./textures/north.xpm
SO ./textures/south.xpm
WE ./textures/west.xpm
EA ./textures/east.xpm
111111
100101
101N01
110001
111111
F 220,100,0
C 225,30,0