NO ./textures/north.xpm
SO ./textures/south.xpm
WE ./textures/west.xpm
EA ./textures/east.xpm
F 220,100,0
C 225,30,0

   11111
   10001
11110001
10000001
1000N001111111
10000000000001
1111100000000111111
   10000000000001
   111111000000001
        10000001
        11111111
