NO ./textures/north.xpm
SO ./textures/south.xpm
WE ./textures/west.xpm
EA ./textures/east.xpm
F 220,100,0
C 225,30,0

   11111
   10001
   10N01
   10001
1111000111111
1000000000001
1000000000001
1000000000001
1111111111111
