NO ./textures/north.xpm
SO ./textures/south.xpm
WE ./textures/west.xpm
EA ./textures/east.xpm
F 220,100,0
C 225,30,0

        111111111
        100000001
1111111110000000111111111
1000000000000000000000001
1000000000000000000000001
10N000000000000000000000
1000000000000000000000001
1000000000000000000000001
1111111110000000111111111
        100000001
        111111111
